####################
#.......l.r....d...#
#..................#
#..................#
#..................#
#..................#
#..du....u.........#
#.......l@r....d...#
#..r.....d.........#
#..................#
#.......r..........#
#.......d..........#
#..................#
#............r.....#
###############>####
< 1
v 1
^ 1
> 1
