########################################
#........................>.............#
#.................a............@.......#
######.................................#
#......................................#
#........................b.............#
#..#####.......... ....................#
#.................#....................#
#.................#....................#
#.....#####.......#....................#
#.................#....................#
#.................#....................#
#.................#....................#
#......########################........#
#.................#....................#
#.................#....................#
#.................#....................#
#.................#....................#
#.................#....................#
#.................#....................#
#......................................#
#......................................#
#......................................#
#......................................#
#......................................#
#......................................#
#......................................#
#......................................#
#......................................#
########################################
