
 #  #  ##
 ## # #  #
 # ## #  #
 #  #  ##

  ## ##### ###  #
 #     #   #  # #
 #     #   ###  #
  ##   #   #  # ###
                   

####################
#.>..............@.#
####################
< 15
