        ###
      ###>#######
      #...l.....#
      #.........#
    ###....######
    #r....r...ul#
    ###.#########
 ######.##u##l####
 #uur...........@#
 #################





< 10
^ 1
v 1
