                    
      ##############
      #rr..........#
  #####u##########>#
  #.......u......@.#
  #######.######.###
        #.#    #.#  
        #.######.#  
        #u.......#  
        ##########  
                    
                    
                    
                    
                    
< 10
v 4
> 4
v 4
