....................
.#..#..##......u....
.##.#.#..#....l.r...
.#.##.#..#.....d....
.#..#..##...........
....................
..##.#####.###..#...
.#.....#...#..#.#...
.#.....#...###..#...
..##...#...#..#.###.
....................
....................
####################
#.>..............@.#
####################
